********
*P     *
*      *
*      *
*      *
*      *
*      *
********
@
********
**P   **
*      *
*  **  *
*  **  *
*      *
**    **
********
@
********
*P     *
*  **  *
*      *
*      *
*  **  *
*      *
********