********
*P     *
*      *
*      *
*      *
*      *
*     E*
********
@
********
**P   **
*      *
*  **  *
*  **  *
*      *
**   E**
********
@
********
*P     *
*  **  *
*      *
*      *
*  **  *
*     E*
********
@
********
**    **
***  ***
*      *
*      *
***  ***
**   E**
********